//MAP CONVERTED BY dmm2tgm.py THIS HEADER COMMENT PREVENTS RECONVERSION, DO NOT REMOVE
"ay" = (
/obj/machinery/door/airlock/pyro/maintenance/alt{
	dir = 4
	},
/turf/simulated/floor/neutral,
/area/space)
"aR" = (
/obj/storage/secure/closet/fridge,
/obj/item/reagent_containers/food/snacks/takeout{
	pixel_y = 6;
	pixel_x = 5
	},
/obj/item/storage/box/donkpocket_kit,
/obj/item/reagent_containers/food/drinks/noodlecup{
	pixel_y = -6;
	pixel_x = 4
	},
/obj/item/reagent_containers/food/drinks/noodlecup{
	pixel_y = -6
	},
/obj/item/reagent_containers/food/drinks/noodlecup{
	pixel_y = -6;
	pixel_x = -5
	},
/turf/simulated/floor/neutral,
/area/space)
"bn" = (
/obj/submachine/chef_sink/chem_sink{
	pixel_y = 16
	},
/obj/blind_switch{
	pixel_y = 31;
	pixel_x = -11;
	id = "bathroom"
	},
/turf/simulated/floor/neutral,
/area/space)
"cx" = (
/turf/space,
/area/space)
"dp" = (
/obj/machinery/dispenser,
/turf/simulated/floor/engine/caution/north,
/area/space)
"dN" = (
/obj/machinery/door/airlock/pyro/glass/command,
/turf/simulated/floor/neutral,
/area/space)
"ea" = (
/obj/machinery/light/small/floor,
/turf/simulated/floor/neutral,
/area/space)
"ef" = (
/obj/machinery/shuttle/engine/heater{
	icon_state = "alt_heater-M"
	},
/turf/simulated/wall/auto/shuttle,
/area/space)
"ev" = (
/obj/decoration/toiletholder{
	pixel_y = 32
	},
/obj/item/storage/toilet{
	dir = 4
	},
/obj/machinery/light/incandescent{
	dir = 8
	},
/turf/simulated/floor/neutral,
/area/space)
"fb" = (
/obj/machinery/door/poddoor/blast/pyro/podbay_autoclose/miningoutpost_horizontal,
/turf/space,
/area/space)
"fy" = (
/obj/fakeobject/pipe{
	density = 1;
	desc = "A large vessel containing pressurized gas.";
	icon = 'icons/obj/atmospherics/tanks/orange_pipe_tank.dmi';
	name = "Pressure Tank (Plasma)";
	icon_state = "tank-map";
	dir = 1
	},
/turf/simulated/floor/plating,
/area/space)
"fH" = (
/obj/stool/chair/couch/yellow{
	dir = 5
	},
/turf/simulated/floor/carpet/green/standard/edge/se,
/area/space)
"fN" = (
/obj/machinery/shuttle/engine/heater{
	icon_state = "alt_heater-M"
	},
/obj/machinery/shuttle/engine/heater{
	icon_state = "alt_heater-R"
	},
/turf/simulated/wall/auto/shuttle,
/area/space)
"hG" = (
/turf/simulated/floor/carpet/green/standard/edge/west,
/area/space)
"jh" = (
/obj/decal/poster,
/turf/simulated/wall/auto/shuttle,
/area/space)
"jC" = (
/obj/window/auto/reinforced,
/turf/simulated/floor/neutral,
/area/space)
"kb" = (
/obj/stool/chair/comfy/sleek{
	dir = 1
	},
/turf/simulated/floor/neutral,
/area/space)
"la" = (
/obj/machinery/door_control/podbay/miningoutpost{
	pixel_y = 32;
	pixel_x = -8
	},
/obj/decal/cleanable/oil/streak,
/turf/simulated/floor/neutral,
/area/space)
"mF" = (
/obj/machinery/light/incandescent,
/turf/simulated/floor/neutral,
/area/space)
"mY" = (
/obj/table/auto,
/obj/submachine/chef_sink/chem_sink{
	dir = 1
	},
/turf/simulated/floor/neutral,
/area/space)
"nJ" = (
/obj/machinery/light/small/sticky{
	dir = 4
	},
/turf/simulated/floor/plating,
/area/space)
"nO" = (
/obj/item/storage/wall/fire{
	pixel_y = 32
	},
/obj/item/storage/toolbox/mechanical,
/turf/simulated/floor/neutral,
/area/space)
"pg" = (
/obj/machinery/light/incandescent{
	dir = 8
	},
/turf/simulated/floor/orange,
/area/space)
"ql" = (
/turf/simulated/floor/engine/caution/north,
/area/space)
"qJ" = (
/obj/table/auto,
/obj/machinery/microwave,
/obj/machinery/light/incandescent,
/turf/simulated/floor/neutral,
/area/space)
"rj" = (
/obj/indestructible/shuttle_corner{
	dir = 1
	},
/turf/space,
/area/space)
"ru" = (
/turf/simulated/wall/auto/shuttle,
/area/space)
"tK" = (
/obj/machinery/computer/camera_viewer/console_lower{
	dir = 4
	},
/turf/simulated/floor/neutral,
/area/space)
"tO" = (
/obj/machinery/computer/television,
/turf/simulated/floor/carpet/green/standard/edge/nw,
/area/space)
"uE" = (
/obj/machinery/portable_atmospherics/canister/oxygen,
/obj/machinery/light/incandescent{
	dir = 1
	},
/turf/simulated/floor/carpet/green/standard/edge/ne,
/area/space)
"vr" = (
/obj/machinery/computer3/generic/shield_control/console_lower{
	dir = 8
	},
/turf/simulated/floor/neutral,
/area/space)
"vP" = (
/obj/decal/poster/miners_almanac,
/turf/simulated/wall/auto/shuttle,
/area/space)
"vU" = (
/obj/machinery/door/airlock/pyro/engineering{
	dir = 4
	},
/turf/simulated/floor/neutral,
/area/space)
"wl" = (
/obj/item/wrench{
	pixel_y = -3;
	pixel_x = -5
	},
/turf/simulated/floor/neutral,
/area/space)
"xK" = (
/obj/machinery/door/airlock/pyro/maintenance/alt{
	dir = 4
	},
/turf/space,
/area/space)
"yE" = (
/obj/machinery/shower{
	dir = 8
	},
/obj/window/north,
/turf/simulated/floor/neutral,
/area/space)
"yT" = (
/obj/machinery/computer/power_monitor/console_upper{
	dir = 8
	},
/turf/simulated/floor/neutral,
/area/space)
"zd" = (
/obj/fakeobject/console_lever,
/turf/simulated/floor/neutral,
/area/space)
"zC" = (
/obj/machinery/shuttle/engine/heater{
	icon_state = "alt_heater-R"
	},
/turf/simulated/wall/auto/shuttle,
/area/space)
"AM" = (
/obj/machinery/shuttle/engine/propulsion{
	icon_state = "alt_propulsion"
	},
/turf/space,
/area/space)
"BI" = (
/obj/storage/closet/dresser,
/obj/item/clothing/under/rank/overalls{
	pixel_x = 8;
	pixel_y = 8
	},
/obj/item/clothing/suit/lined_jacket{
	pixel_y = 6;
	pixel_x = -6
	},
/obj/item/clothing/under/misc/collar_shirt/pink{
	pixel_y = 2;
	pixel_x = 2
	},
/obj/item/clothing/under/misc/dress,
/obj/item/clothing/under/swimsuit/black{
	pixel_y = -4;
	pixel_x = -4
	},
/obj/item/clothing/under/shorts/black{
	pixel_y = -8;
	pixel_x = -8
	},
/obj/item/clothing/shoes/brown{
	pixel_x = 6;
	pixel_y = -10
	},
/turf/simulated/floor/carpet/green/standard/edge/south,
/area/space)
"BK" = (
/obj/machinery/recharger/wall/sticky{
	dir = 8
	},
/turf/simulated/floor/orange,
/area/space)
"BM" = (
/obj/table/auto,
/obj/machinery/computer3/generic/personal,
/turf/simulated/floor/neutral,
/area/space)
"BV" = (
/obj/machinery/door/airlock/pyro/external{
	dir = 4
	},
/turf/simulated/floor/neutral,
/area/space)
"CN" = (
/turf/simulated/floor/engine,
/area/space)
"EO" = (
/obj/machinery/nanofab/mining,
/turf/simulated/floor/orange,
/area/space)
"Fz" = (
/obj/item/storage/wall/medical{
	dir = 4;
	pixel_x = -32
	},
/obj/stool/bed,
/obj/item/clothing/suit/bedsheet/orange,
/obj/item/clothing/under/rank/orangeoveralls/yellow,
/turf/simulated/floor/carpet/green/standard/edge/north,
/area/space)
"FN" = (
/obj/machinery/drainage,
/obj/machinery/door/window/northleft,
/turf/simulated/floor/neutral,
/area/space)
"Gg" = (
/obj/table/auto,
/obj/machinery/recharger,
/obj/machinery/light/incandescent{
	dir = 1
	},
/obj/item/reagent_containers/glass/oilcan,
/turf/simulated/floor/orange,
/area/space)
"Gx" = (
/turf/simulated/floor/engine/caution/east,
/area/space)
"GT" = (
/obj/reagent_dispensers/fueltank,
/turf/simulated/floor/plating,
/area/space)
"HM" = (
/obj/indestructible/shuttle_corner,
/turf/space,
/area/space)
"HT" = (
/obj/table/auto,
/obj/machinery/coffeemaker,
/obj/drink_rack/mug{
	pixel_x = 32
	},
/turf/simulated/floor/neutral,
/area/space)
"IX" = (
/obj/item/clothing/under/misc/casualjeansgrey{
	pixel_x = 8;
	pixel_y = 8
	},
/turf/simulated/floor/carpet/green/standard/edge/se,
/area/space)
"JR" = (
/obj/machinery/shuttle/engine/heater{
	icon_state = "alt_heater-L"
	},
/turf/simulated/wall/auto/shuttle,
/area/space)
"NJ" = (
/turf/simulated/floor/neutral,
/area/space)
"NQ" = (
/turf/simulated/floor/carpet/green/standard/edge/east,
/area/space)
"Oz" = (
/obj/stool/chair/couch/yellow{
	dir = 9
	},
/turf/simulated/floor/carpet/green/standard/edge/sw,
/area/space)
"OM" = (
/obj/window/auto/reinforced,
/obj/window_blinds/vertical{
	id = "bathroom"
	},
/turf/simulated/floor/neutral,
/area/space)
"OO" = (
/obj/machinery/r_door_control/podbay/miningoutpost/new_walls/north,
/turf/space,
/area/space)
"Pl" = (
/turf/simulated/floor/orange,
/area/space)
"Ps" = (
/turf/simulated/floor/engine/caution/corner{
	dir = 1
	},
/area/space)
"PY" = (
/obj/machinery/computer3/generic/communications/console_upper{
	dir = 4
	},
/turf/simulated/floor/neutral,
/area/space)
"Qn" = (
/obj/fitness/speedbag,
/turf/simulated/floor/engine/caution/corner,
/area/space)
"RJ" = (
/turf/simulated/floor/carpet/green/standard/edge/ne,
/area/space)
"RR" = (
/obj/machinery/manufacturer/general,
/turf/simulated/floor/orange,
/area/space)
"Sv" = (
/obj/window/auto/crystal/reinforced,
/turf/simulated/floor/neutral,
/area/space)
"Tn" = (
/obj/machinery/ore_cloud_storage_container,
/turf/simulated/floor/orange,
/area/space)
"TZ" = (
/obj/stool/chair/office/yellow{
	dir = 4
	},
/turf/simulated/floor/neutral,
/area/space)
"Un" = (
/obj/fitness/stacklifter,
/turf/simulated/floor/engine/caution/corner{
	dir = 4
	},
/area/space)
"UR" = (
/obj/machinery/door/airlock/pyro/glass/reinforced,
/turf/simulated/floor/neutral,
/area/space)
"UT" = (
/obj/rack,
/obj/item/mining_tool/powered/hammer{
	pixel_y = 3;
	pixel_x = 4
	},
/obj/item/storage/belt/mining{
	pixel_y = -7
	},
/obj/item/gun/energy/phaser_smg/extended_mag{
	pixel_y = -1;
	pixel_x = 9
	},
/obj/item/clothing/suit/space/industrial,
/obj/item/clothing/head/helmet/space/industrial{
	pixel_y = -6;
	pixel_x = -8
	},
/turf/simulated/floor/orange,
/area/space)
"Vh" = (
/obj/machinery/manufacturer/hangar,
/turf/simulated/floor/orange,
/area/space)
"Vi" = (
/obj/table/auto,
/obj/item/reagent_containers/food/drinks/energyshake{
	pixel_y = 11;
	pixel_x = 8
	},
/turf/simulated/floor/neutral,
/area/space)
"Wd" = (
/obj/machinery/manufacturer/mining,
/turf/simulated/floor/orange,
/area/space)
"Wq" = (
/turf/simulated/floor/plating,
/area/space)
"WO" = (
/obj/machinery/vehicle/pod_smooth/gold,
/turf/simulated/floor/engine,
/area/space)
"WP" = (
/obj/decal/cleanable/oil/streak,
/turf/simulated/floor/engine/caution/north,
/area/space)
"XS" = (
/obj/fakeobject/pipe{
	density = 1;
	desc = "A large vessel containing pressurized gas.";
	icon = 'icons/obj/atmospherics/tanks/white_red_pipe_tank.dmi';
	name = "Pressure Tank";
	icon_state = "tank-map";
	dir = 1
	},
/turf/simulated/floor/plating,
/area/space)
"Yv" = (
/obj/item/storage/wall/emergency{
	pixel_y = 32
	},
/obj/machinery/light/small/floor,
/turf/simulated/floor/neutral,
/area/space)
"Zf" = (
/obj/machinery/light/incandescent{
	dir = 1
	},
/obj/fitness/weightlifter,
/turf/simulated/floor/engine/caution/corner{
	dir = 8
	},
/area/space)
"Zn" = (
/turf/simulated/floor/engine/caution/west,
/area/space)
"Zq" = (
/obj/item/clothing/shoes/bootsblk,
/turf/simulated/floor/neutral,
/area/space)

(1,1,1) = {"
cx
cx
cx
cx
cx
cx
cx
cx
cx
cx
cx
cx
cx
cx
cx
cx
cx
cx
cx
cx
cx
cx
cx
cx
cx
cx
cx
cx
cx
cx
"}
(2,1,1) = {"
cx
cx
cx
cx
cx
cx
cx
cx
cx
cx
cx
cx
cx
cx
cx
cx
cx
cx
cx
cx
cx
cx
cx
cx
cx
cx
cx
cx
cx
cx
"}
(3,1,1) = {"
cx
cx
cx
cx
cx
cx
cx
cx
cx
cx
cx
cx
cx
cx
cx
cx
cx
cx
cx
cx
cx
cx
cx
cx
cx
cx
cx
cx
cx
cx
"}
(4,1,1) = {"
cx
cx
cx
cx
cx
cx
cx
cx
cx
cx
cx
cx
cx
cx
cx
cx
cx
cx
cx
cx
cx
cx
cx
cx
cx
cx
cx
cx
cx
cx
"}
(5,1,1) = {"
cx
cx
cx
cx
cx
cx
cx
cx
cx
cx
cx
cx
cx
cx
cx
cx
cx
cx
cx
cx
cx
cx
cx
cx
cx
cx
cx
cx
cx
cx
"}
(6,1,1) = {"
cx
cx
cx
cx
cx
cx
cx
cx
cx
cx
cx
cx
cx
cx
cx
cx
cx
cx
cx
cx
cx
cx
cx
cx
cx
cx
cx
cx
cx
cx
"}
(7,1,1) = {"
cx
cx
cx
cx
cx
cx
cx
cx
cx
cx
cx
cx
cx
cx
cx
cx
cx
cx
cx
cx
cx
cx
cx
cx
cx
cx
cx
cx
cx
cx
"}
(8,1,1) = {"
cx
cx
cx
cx
cx
cx
cx
cx
cx
cx
cx
cx
cx
cx
cx
cx
cx
cx
cx
cx
cx
cx
cx
cx
cx
cx
cx
cx
cx
cx
"}
(9,1,1) = {"
cx
cx
cx
cx
cx
cx
cx
cx
cx
cx
cx
cx
cx
cx
cx
cx
cx
cx
cx
cx
cx
cx
cx
cx
cx
cx
cx
cx
cx
cx
"}
(10,1,1) = {"
cx
cx
cx
cx
cx
cx
cx
cx
HM
OM
ru
ru
jC
jC
ru
JR
AM
cx
cx
cx
cx
cx
cx
cx
cx
cx
cx
cx
cx
cx
"}
(11,1,1) = {"
cx
cx
cx
cx
cx
cx
HM
BV
ru
ev
yE
ru
GT
XS
fy
ef
AM
cx
cx
cx
cx
cx
cx
cx
cx
cx
cx
cx
cx
cx
"}
(12,1,1) = {"
cx
cx
cx
cx
cx
cx
ru
Yv
ru
bn
FN
ru
Wq
nJ
Wq
fN
AM
cx
cx
cx
cx
cx
cx
cx
cx
cx
cx
cx
cx
cx
"}
(13,1,1) = {"
cx
cx
cx
cx
cx
HM
ru
BV
ru
ay
ru
ru
ay
ru
xK
ru
ru
ru
OO
cx
cx
cx
cx
cx
cx
cx
cx
cx
cx
cx
"}
(14,1,1) = {"
cx
cx
HM
Sv
Sv
ru
Zf
Zn
Qn
Zq
Fz
BI
mF
ru
NJ
dp
CN
fb
cx
cx
cx
cx
cx
cx
cx
cx
cx
cx
cx
cx
"}
(15,1,1) = {"
cx
cx
Sv
PY
tK
ru
Un
Gx
Ps
NJ
RJ
IX
NJ
ru
nO
WP
CN
fb
cx
cx
cx
cx
cx
cx
cx
cx
cx
cx
cx
cx
"}
(16,1,1) = {"
cx
cx
Sv
zd
kb
dN
NJ
NJ
BM
TZ
ea
NJ
NJ
UR
wl
ql
CN
fb
cx
cx
cx
cx
cx
cx
cx
cx
cx
cx
cx
cx
"}
(17,1,1) = {"
cx
cx
Sv
yT
vr
jh
tO
hG
Oz
Vi
NJ
NJ
mY
ru
la
ql
WO
fb
cx
cx
cx
cx
cx
cx
cx
cx
cx
cx
cx
cx
"}
(18,1,1) = {"
cx
cx
rj
Sv
Sv
ru
uE
NQ
fH
aR
NJ
HT
qJ
ru
NJ
ql
CN
fb
cx
cx
cx
cx
cx
cx
cx
cx
cx
cx
cx
cx
"}
(19,1,1) = {"
cx
cx
cx
cx
cx
rj
ru
BV
ru
ru
vU
ru
ru
ru
vU
ru
ru
ru
cx
cx
cx
cx
cx
cx
cx
cx
cx
cx
cx
cx
"}
(20,1,1) = {"
cx
cx
cx
cx
cx
cx
ru
Yv
vP
UT
Pl
Pl
BK
pg
Pl
JR
AM
cx
cx
cx
cx
cx
cx
cx
cx
cx
cx
cx
cx
cx
"}
(21,1,1) = {"
cx
cx
cx
cx
cx
cx
rj
BV
ru
Gg
RR
Wd
EO
Vh
Tn
ef
AM
cx
cx
cx
cx
cx
cx
cx
cx
cx
cx
cx
cx
cx
"}
(22,1,1) = {"
cx
cx
cx
cx
cx
cx
cx
cx
rj
jC
ru
ru
jC
jC
ru
zC
AM
cx
cx
cx
cx
cx
cx
cx
cx
cx
cx
cx
cx
cx
"}
(23,1,1) = {"
cx
cx
cx
cx
cx
cx
cx
cx
cx
cx
cx
cx
cx
cx
cx
cx
cx
cx
cx
cx
cx
cx
cx
cx
cx
cx
cx
cx
cx
cx
"}
(24,1,1) = {"
cx
cx
cx
cx
cx
cx
cx
cx
cx
cx
cx
cx
cx
cx
cx
cx
cx
cx
cx
cx
cx
cx
cx
cx
cx
cx
cx
cx
cx
cx
"}
(25,1,1) = {"
cx
cx
cx
cx
cx
cx
cx
cx
cx
cx
cx
cx
cx
cx
cx
cx
cx
cx
cx
cx
cx
cx
cx
cx
cx
cx
cx
cx
cx
cx
"}
(26,1,1) = {"
cx
cx
cx
cx
cx
cx
cx
cx
cx
cx
cx
cx
cx
cx
cx
cx
cx
cx
cx
cx
cx
cx
cx
cx
cx
cx
cx
cx
cx
cx
"}
(27,1,1) = {"
cx
cx
cx
cx
cx
cx
cx
cx
cx
cx
cx
cx
cx
cx
cx
cx
cx
cx
cx
cx
cx
cx
cx
cx
cx
cx
cx
cx
cx
cx
"}
(28,1,1) = {"
cx
cx
cx
cx
cx
cx
cx
cx
cx
cx
cx
cx
cx
cx
cx
cx
cx
cx
cx
cx
cx
cx
cx
cx
cx
cx
cx
cx
cx
cx
"}
(29,1,1) = {"
cx
cx
cx
cx
cx
cx
cx
cx
cx
cx
cx
cx
cx
cx
cx
cx
cx
cx
cx
cx
cx
cx
cx
cx
cx
cx
cx
cx
cx
cx
"}
(30,1,1) = {"
cx
cx
cx
cx
cx
cx
cx
cx
cx
cx
cx
cx
cx
cx
cx
cx
cx
cx
cx
cx
cx
cx
cx
cx
cx
cx
cx
cx
cx
cx
"}
